NO ./no.xpm
SO ./so.xpm
WE ./we.xpm
EA ./ea.xpm
F 220,100,0
C 225,30,0
1111111111111111111111111
1E00000000110000000000001
