NO ./textures/texture_no1.png
SO ./textures/texture_so1.png
WE ./textures/texture_we1.png
EA ./textures/texture_ea1.png
F 204,153,255
C 128,14,140
111111111111111111111111111111111
101000000000000000000000000000011
111000111111111111111111111100011
111000100000000000000000001100011
111000101111111111111111101100011
111000101000000000000000101100011
111000101010000000000010101100011                        11111111111111111
111000101010111111111010101100011                        10000000100000001
111000101010100000001010101100011                        10000010101000001
111000101010101111101010101100011                        10000110001100001
111000101010101000101010101100011                        10000100000100001
111000101010101010101010101100011                        10000110001100001
111000101010101010101010101100011                        10000011111000001
111000101010101010101010101100011                        10000000000000001
111000101010101010101010101100011                        11111111011111111
111000101010101010101010101100011                               101
111000101010101010101010101100011                               101
111000101010101010101010101100011                               101
111000101010101010101010101100011                               101
111000101010101010101010101100011                               101
111000101010101010101010101100011                               101
111000101010101010101010101100011                               101
111000000000000000000000000000011                               101
111000101010101010101010101100011                               101
111000101010101010101010101100011                               101
111000101010101010101010101100011                               101
111000101010101010101010101100011111111111                      101
111000101010101010101010101100000000000001                      101
111000101010101010101010101100011111111101                      101
1110001000000000000000000000000W11     101                      101
111111111111111111111111111111111      101                      101
1111111111111111111111111111111111111111011111111111111111111111101
1000000000000000000000000000000000000000000000000000000000000000001
1000000000000000000000000000000000000000000000000000000000000000111
10000000000000000000000000000000000000000000000000000000000000001
10001110001110001110001110001110001110001110001110001110001110001
10001110001110001110001110001110001110001110001110001110001110001
10001110001110001110001110001110001110001110001110001110001110001
10000000000000000000000000000000000000000000000000000000000000001
10000000000000000000000000000000000000000000000000000000000000001
10000000000000000000000000000000000000000000000000000000000000001
10001110001110001110001110001110001110001110001110001110001110001
10001110001110001110001110001110001110001110001110001110001110001
10001110001110001110001110001110001110001110001110001110001110001
10000000000000000000000000000000000000000000000000000000000000001
10000000000000000000000000000000000000000000000000000000000000001
10000000000000000000000000000000000000000000000000000000000000001
10001110001110001110001110001110001110001110001110001110001110001
10001110001110001110001110001110001110001110001110001110001110001
10001110001110001110001110001110001110001110001110001110001110001
10000000000000000000000000000000000000000000000000000000000000001
10000000000000000000000000000000000000000000000000000000000000001
10000000000000000000000000000000000000000000000000000000000000001
10001110001110001110001110001110001110001110001110001110001110001
10001110001110001110001110001110001110001110001110001110001110001
10001110001110001110001110001110001110001110001110001110001110001
10000000000000000000000000000000000000000000000000000000000000001
10000000000000000000000000000000000000000000000000000000000000001
10000000000000000000000000000000000000000000000000000000000000001
10001110001110001110001110001110001110001110001110001110001110001
10001110001110001110001110001110001110001110001110001110001110001
10001110001110001110001110001110001110001110001110001110001110001
10000000000000000000000000000000000000000000000000000000000000001
10000000000000000000000000000000000000000000000000000000000000001
10000000000000000000000000000000000000000000000000000000000000001
10001110001110001110001110001110001110001110001110001110001110001
10001110001110001110001110001110001110001110001110001110001110001
10001110001110001110001110001110001110001110001110001110001110001
10000000000000000000000000000000000000000000000000000000000000001
10000000000000000000000000000000000000000000000000000000000000001
10000000000000000000000000000000000000000000000000000000000000001
10001110001110001110001110001110001110001110001110001110001110001
10001110001110001110001110001110001110001110001110001110001110001
10001110001110001110001110001110001110001110001110001110001110001
10000000000000000000000000000000000000000000000000000000000000001
10000000000000000000000000000000000000000000000000000000000000001
10000000000000000000000000000000000000000000000000000000000000001
10001110001110001110001110001110001110001110001110001110001110001
10001110001110001110001110001110001110001110001110001110001110001
10001110001110001110001110001110001110001110001110001110001110001
10000000000000000000000000000000000000000000000000000000000000001
10000000000000000000000000000000000000000000000000000000000000001
10000000000000000000000000000000000000000000000000000000000000001
10001110001110001110001110001110001110001110001110001110001110001
10001110001110001110001110001110001110001110001110001110001110001
10001110001110001110001110001110001110001110001110001110001110001
10000000000000000000000000000000000000000000000000000000000000001
10000000000000000000000000000000000000000000000000000000000000001
10000000000000000000000000000000000000000000000000000000000000001
11111111111111111111111111111111111111111011111111111111111111111
                                        101
111111111111111111111111111111111111111110111111111111111111111111111111111111111111111111111111111111111
100101000000011000100000010000000010010010000000000110000000011000100110011000000100010001000010000000001
100010001000000100000000100001011000110000000000100011010100000000001000100000001000000001000000011001001
100010001000000010100100010100110010000001110000000000010000000000000000110000000000000100100000000000001
100010000001001000000001100000000100001001000001001000000100001001100100000010001001010000010100010001001
100100001100000000000010000000010101110000100010000000000100110010001000001011001001000001100000110101001
110000010000001000000010000000000010000000100100010100001000000100001010000010000000000001000000001110001
100000000011000000100000000100010000010001001001000000000000010100000000001010000000100000100010000010011
100010000100010100100101010001000100010001001100001010000001100000100100000000000001001011000000100010011
100000001100100101000000010111000010000000001101000000010100100000000010100100000010000000000000100010011
100010000101101000001100010000000010000001000010100011000000000010001001000001000010001000000010010100001
110001000100000010000100000000001100100000000001000011000000000100000000111101000000011000000000000110011
100000000000000000101000110000100000100000110010011010000001100001100000000000110010000010000000100010001
100010000000001010100001000001000011000000010000100101100000010000010001000000100010000001000100100101011
100000001010010010000000000000000000010000100100100000100000100111010000010100000000010000001000100010001
101000000000100010001010011000000100000100010000010100000110000001000000001000001011100001001000101000001
100001000000001001100000000000100000000000010000100100000000000000010011000100100000100100000001100000111
101010001100000010000110101001000100001001001001001000000100000001000000100001000000010000000001100100111
101000010000000001001000100000000001001001000010100010001000000010000000010000010000001001000101001000001
111111111111111111111111111111111111111111111111111111111111111111111111111111111111111111111111111111111
